111111111111
1E1001000111
1E11111111E1
1P100P00PP11
111111000111
111111111111
