111111111111111111111111
1E1111111111111111111111
1C1111100000011111111111
1P1111111111111111111111
10000000000101110CE11111
111111111111111111111111
111111111111111111111111
111111111111111111111111
111111111111111111111111
111111111111111111111111
111111111111111111111111
