1111111111111111111
1100000000000000011
1100010000000000011
110001000E000000011
1100010001000000011
110000C001000000011
1100000001100P00011
1100000C001C0000011
1100000000000000011
1111111111111111111
