11111111111111111
111111P000001EC11
10000000000011111
11111111111111111
