# 0 for an empty space, 
# 1 for a wall, 
# C for a collectible, 
# E for a map exit, 
# P for the player's starting position.

11111
100C1
10001
1PE01
11111
