111111111
1CCCCCCC1
1C11P11C1
1CCCCCCC1
111111111
