1111111111
1000000001
1000000001
100E000001
1000P00001
10000C0001
100000A001
1000000001
1000000001
1000000001
1111111111
