11111111
1E0P1C01
10111111
101000C1
10101101
10100101
10100101
10111101
10C00001
10111101
10000001
11111111
