111111111
100000001
1011E1101
1011P1101
100000001
111111111
