# contains multiple E(exit) chars

11111111111111111111
10000000000000000001
10000000000000000001
10E00C000000000E0001
10000000000000000001
10000000000000000001
10000000000000000001
10000E00000P00000001
10000000000000000001
11111111111111111111
