111111111
111888111
111888111
111888111
111888111
111888111
111888111
111888111
111888111
111111111
