# contains multiple P(player) chars

11111111111111111111
10000000000000000001
10000000000000000001
10E00C00000000000001
10000000000000000001
10000000000000000001
10000000000000000001
10000P00000P00000001
10000000000000000001
11111111111111111111
