111111
1000P1
101111
100001
111C01
100001
101111
100001
111011
1C00C1
111011
110011
100111
101101
101E11
101101
100001
111111
