1111111111111111
1000000000000001
1000001111000001
1000001PC1000001
1000001111000001
1000000000000001
1000001CE1000001
1111111111111111
