1111111111
1111111111
0111111111
0111111111
0111111111
0111111111
0111111111
0111111111
1111111111
