1111111111
1111111111
1111111111
1111011111
1111011111
1111011111
1111011111
1111111111
1111111111
1111111111
