11111
11111
1P0P1
10001
10101
10C01
10101
10E01
10001
11111
