1111111
1100001
1E0P001
1100001
1100001
1100001
1100001
1100001
1100001
1111101
100C101
1000101
1000101
100E101
1011101
1010001
1010001
1011001
10C1001
1000001
1000001
1111111
