# 0 for an empty space, 
# 1 for a wall, 
# C for a collectible, 
# E for a map exit, 
# P for the player's starting position.

111111
1C0111
100011
1PE011
10U111
