# This is a comment

11111011
11111111
1000011
1456758690000000100002EEE1
11111111111
14432243
