# This is a comment

11111011
11111111
1000011
145675869000000010000
11111111111
14432243
