# smallest possible map

11111
1ECP1
11111
