111111111111111111111111111111111111111111111111111111111111111111111111111111111111111
10P01E0000000000000C0000000000000000000000000000000000000000000010000000000000000000011
111111111111111111111111111111111111111111111111111111111111111111111111111111111111111
