111111111111111111111111111111111111111111111111111111111111111111111111111111111111111
10P00E000000000000000000000000000000000000000000000000000000000000000000000000000000011
111111111111111111111111111111111111111111111111111111111111111111111111111111111111111
