11111111
11P10001
10010001
101101E1
10110111
10110111
101C0111
10010111
100100C1
10010011
10010011
10011011
10001001
11100001
1C000001
11111111
